step,type,amount,nameOrig,oldbalanceOrg,newbalanceOrig,nameDest,oldbalanceDest,newbalanceDest
459,TRANSFER,4153.02,C1504417393,4153.02,0.0,C413981813,0.0,0.0
459,CASH_OUT,4153.02,C1685125917,4153.02,0.0,C1463620824,0.0,4153.02
459,TRANSFER,46130.88,C1045907901,46130.88,0.0,C1384446029,0.0,0.0
459,CASH_OUT,46130.88,C1862849619,46130.88,0.0,C1553982195,0.0,46130.88
459,TRANSFER,1153156.0,C1788207069,1153156.0,0.0,C2113625922,0.0,0.0
459,CASH_OUT,1153156.0,C165575041,1153156.0,0.0,C1041543827,0.0,1153156.0
459,TRANSFER,277611.08,C1304518547,277611.08,0.0,C230736806,0.0,0.0
459,CASH_OUT,277611.08,C2028451849,277611.08,0.0,C677754789,1588077.25,1865688.33
