step,type,amount,nameOrig,oldbalanceOrg,newbalanceOrig,nameDest,oldbalanceDest,newbalanceDest
486,TRANSFER,143500.62,C1190315879,143500.62,0.0,C1109288229,0.0,0.0
486,CASH_OUT,143500.62,C1105017179,143500.62,0.0,C1386404249,0.0,143500.62
486,TRANSFER,4505012.56,C1899244815,4505012.56,0.0,C1848485369,0.0,0.0
486,CASH_OUT,4505012.56,C1075946907,4505012.56,0.0,C1978376659,0.0,4505012.56
486,TRANSFER,1290619.25,C1298336422,1290619.25,0.0,C66079679,0.0,0.0
486,CASH_OUT,1290619.25,C790188952,1290619.25,0.0,C472356199,0.0,1290619.25
486,TRANSFER,214793.32,C2140495649,214793.32,0.0,C423543548,0.0,0.0
486,CASH_OUT,214793.32,C852832309,214793.32,0.0,C781959592,0.0,214793.32
