step,type,amount,nameOrig,oldbalanceOrg,newbalanceOrig,nameDest,oldbalanceDest,newbalanceDest
89,TRANSFER,766631.82,C112075481,766631.82,0.0,C1906745138,0.0,0.0
89,CASH_OUT,766631.82,C876716683,766631.82,0.0,C1473416514,0.0,766631.82
89,TRANSFER,43928.31,C1832804428,43928.31,0.0,C1373339236,0.0,0.0
89,CASH_OUT,43928.31,C2129914105,43928.31,0.0,C170080123,0.0,43928.31
89,TRANSFER,268230.43,C163362068,268230.43,0.0,C2101762472,0.0,0.0
89,CASH_OUT,268230.43,C810552146,268230.43,0.0,C400913352,0.0,268230.43
